RT___T_____T
_T_T_T_TTT_T
_T_T_T_T___T
_T_T_T_T_TTT
_T_T_T_T___T
_T_T_T_TTT_T
_T_T_T_T___T
_T_T_T_T_TTT
_T_T_T_T___T
_T_T_T_TT_TT
_T_T_T_T__TT
___T___TT__C
