TTTTTTTTTTTT
T___T___T___
T_T___T___T_
T_TTTTTTT_T_
T_T_____T_T_
T_T_TTT_T_T_
T_T_TRT_T_T_
T_T_T_T_T_T_
T_T___T_T_T_
T_TTTTT_T_T_
T_______T_T_
TTTTTTTTTCT_
