TTTTTTTTTTTT
T__________T
T_TTTTTTTT_T
T_T____T_T_T
T_T_TT_T_T_T
T_T_RT_T_T_T
T_T__T_T_T_T
T_TTTT_T_T_T
T______T_T_T
TTTTTTTT_T_T
CT___T___T_T
___T___T____
